row,col,char,text
9,10,"D","map_1"
start.pos,"7 9"
open.char," "
bg,"bggrey"
special.char,"@"
*-----------------*
|        +        |
|        A      W |
| ______   ____   |
| _______ _______ |
| _______ _______ |
|  ______ _______ |
|R                |
*--------D--------*
