row,col,char,text
9,10,"D","map_1"
start.pos,"7 9"
open.char," "
bg,"bggrey"
special.char,"@"
*-----------------*
|        +        |
|        A        |
| ______   ______ |
| _______ _______ |
| _______ _______ |
| _______ ______  |
|                R|
*--------D--------*
